NO ./textures/firewall.png
SO ./textures/redbrick.png
WE ./textures/graystone.png
EA ./textures/purplestone.png

C   192,217,217
F 	189,189,189

        1111111111111111111111111
        1000000000110000000000001
        1011000001110000000000001
        100100000000000000E000001
111111111011000001110000000000101
100000000011000001110111111111111
11110111111111111100000010001
11110111111111011101010000001
11000000110101011100000001001
10000000000000001100000010001
10000000000000000001010010001
1100000111010101111101111000111
11110111 1110101 101111010001
11111111 1111111 111111111111