NO ./textures/graystone.png
SO ./textures/graystone.png
WE ./textures/graystone.png
EA ./textures/graystone.png

F 169, 159, 147
C 173, 216, 230

        1111111111111111111111111
        1000000000110000000000001
        1011000001110N00000000001
        1001000000000000000000001
111111111011000001110000000000101
100000000011000001110111111111111
11110111111111111100000010001
11110111111111011101010000001
11000000110101011100000001001
10000000000000001100000010001
10000000000000001101010010001
1100000111010101111101111000111
11110111 1110101 101111010001
11111111 1111111 111111111111